


      
F 220  ,   100 ,0

                 NO                    ./textures/64x64/redbrick.xpm
                        SO  ./textures/64x64/wood.xpm
WE                                ./textures/64x64/bluestone.xpm
C 225            ,30            ,0      
EA ./textures/64x64/mossy.xpm

1111
1N01
1111
