NO./textures/64x64/barrel.xpm
SO ./textures/64x64/mossy.xpm
WE ./textures/64x64/mossy.xpm
EA ./textures/128x128/tile.xpm
F 76, 181, 31
C 166, 224, 255

111111111111111111
100000000000000001
100000000000000001
100000000111111111
100000000000000001
100000000000000001
100000000000000001
100000000000000001
100000000000000001
100000000000000001
100000000000000001
100000000000000001
100000000000000001
100000000000000001
10000N000000000001
111111111111111111
